{
  "size": 11,
  "origin": [5, 5],
  "map": [
    [1, 1, 1, 1, 2, 2, 2, 1, 1, 1, 1],
    [1, 0, 0, 1, 0, 0, 0, 0, 0, 0, 1],
    [1, 0, 0, 0, 0, 0, 0, 0, 0, 0, 1],
    [1, 1, 1, 1, 0, 0, 0, 0, 2, 0, 1],
    [1, 0, 0, 0, 0, 0, 0, 0, 2, 0, 1],
    [1, 0, 0, 0, 0, 0, 0, 0, 2, 2, 1],
    [1, 0, 0, 2, 2, 1, 0, 0, 0, 0, 1],
    [1, 0, 0, 0, 0, 1, 0, 0, 0, 0, 1],
    [1, 0, 0, 0, 0, 1, 0, 0, 0, 0, 1],
    [1, 0, 0, 0, 0, 1, 0, 0, 0, 0, 1],
    [1, 2, 2, 1, 1, 1, 1, 1, 2, 2, 1]
  ],
  "textures": ["stone_bricks.png", "mossy_cobblestone.png"]
}
